00500213
00500313
000302b3
00320413
00420493
004483b3
